########################
#s.....................#
#......................#
#......................#
#......................#
#......................#
#......................#
#......................#
#......................#
#......................#
#......................#
#......................#
#......................#
#......................#
#......................#
#......................#
#......................#
#......................#
#......................#
#......................#
#......................#
#......................#
#......................#
#......................#
#......................#
#......................#
#......................#
#......................#
#......................#
########################
