s.......................
##......##......##......
##......##......##......
....##......##......##..
....##......##......##..
##......##......##......
##......##......##......
....##......##......##..
....##......##......##..
##......##......##......
##......##......##......
....##......##......##..
....##......##......##..
##......##......##......
##......##......##......
....##......##......##..
....##......##......##..
##......##......##......
##......##......##......
....##......##......##..
....##......##......##..
##......##......##......
##......##......##......
....##......##......##..
....##......##......##..
##......##......##......
##......##......##......
....##......##......##..
....##......##......##..
........................
