........................
..#.............#.......
...#...#####...........#
....#...................
.....#..............#...
......#.................
.##.....................
.##...........#....#....
###....#..........#....#
......##.........#.....#
......#....#............
....#..............#....
...#................#...
..#.....................
...................#....
#..#..............#.....
#...##.................#
#.....#................#
.......#...............#
........#..............#
........#..............#
#........#.............#
.#........##...........#
..#....................#
.................#.....#
....######.......#.....#
.......................#
....#.............#....#
#...#......##.....##...#
....#...................
