s..........#............
...........#............
...........#............
...........#............
...........#............
...........#............
...........#............
...........#............
...........#............
...........#............
...........#............
...........#............
...........#............
...........#............
...........#............
########################
...........#............
...........#............
...........#............
...........#............
...........#............
...........#............
...........#............
...........#............
...........#............
...........#............
...........#............
...........#............
...........#............
...........#............
