#..#..#..#..#..#..#..#..
#s....#.....#.....#.....
#.....#.....#.....#.....
#..#..#..#..#..#..#..#..
#..#..#..#..#..#..#..#..
#..#..#..#..#..#..#..#..
#..#..#..#..#..#..#..#..
#..#..#..#..#..#..#..#..
#..#..#..#..#..#..#..#..
#..#..#..#..#..#..#..#..
#..#..#..#..#..#..#..#..
#..#..#..#..#..#..#..#..
#..#..#..#..#..#..#..#..
#..#..#..#..#..#..#..#..
#..#..#..#..#..#..#..#..
#..#..#..#..#..#..#..#..
#..#..#..#..#..#..#..#..
#..#..#..#..#..#..#..#..
#..#..#..#..#..#..#..#..
#..#..#..#..#..#..#..#..
#..#..#..#..#..#..#..#..
#..#..#..#..#..#..#..#..
#..#..#..#..#..#..#..#..
#..#..#..#..#..#..#..#..
#..#..#..#..#..#..#..#..
#..#..#..#..#..#..#..#..
#..#..#..#..#..#..#..#..
...#.....#.....#.....#..
...#.....#.....#.....#..
#..#..#..#..#..#..#..#..
